{
    "type": "JSON",
    "tileSize": 64,
    "spawnCol": 8, "spawnRow": 20, "spawnAngle": 270,
    "map": [
        "00000000000000000000000000000000000000000000000000",
        "00000000000000000000000000000000000000000000000000",
        "00000000000000000000000000000000000000000000000000",
        "00000000000000000000000000000000000000000000000000",
        "00000000000000000000000000000000000000000000000000",
        "00000000000000000000000000000000000000000000000000",
        "00000000000000000000000000000000000000000000000000",
        "000000000000000------------00000000000000000000000",
        "00000000000-------------------00000000000000000000",
        "0000000000---------------------0000000000000000000",
        "000000000------------------------00000000000000000",
        "00000000--------0000000000--------0000000000000000",
        "00000000-----0000000000000000------000000000000000",
        "00000000----000000000000000000------00000000000000",
        "00000000----0000000000000000000------0000000000000",
        "0000000-----00000000000000000000------000000000000",
        "0000000----0000000000000000000000------00000000000",
        "0000000----00000000000000000000000------0000000000",
        "0000000----000000000000000000000000------000000000",
        "0000000----0000000000000000000000000------00000000",
        "0000000----00000000000000000000000000-----00000000",
        "0000000----0000000000---------00000000-----0000000",
        "0000000----00000000-------------000000-----0000000",
        "0000000----0000000---------------000000----0000000",
        "0000000----0000000---------------000000----0000000",
        "0000000----000000------00000------00000----0000000",
        "0000000----000000-----0000000-----00000----0000000",
        "0000000----000000-----0000000-----00000----0000000",
        "0000000----000000----000000000----00000----0000000",
        "0000000----000000----000000000----00000----0000000",
        "0000000----000000----000000000-----000-----0000000",
        "0000000----000000----000000000-----000-----0000000",
        "0000000-----0000-----000000000------0------0000000",
        "0000000-----0000-----0000000000-----------00000000",
        "0000000------00------0000000000-----------00000000",
        "00000000------------000000000000---------000000000",
        "00000000------------00000000000000-----00000000000",
        "0000000000----------000000000000000000000000000000",
        "00000000000------000000000000000000000000000000000",
        "00000000000000000000000000000000000000000000000000",
        "00000000000000000000000000000000000000000000000000",
        "00000000000000000000000000000000000000000000000000",
        "00000000000000000000000000000000000000000000000000",
        "00000000000000000000000000000000000000000000000000",
        "00000000000000000000000000000000000000000000000000",
        "00000000000000000000000000000000000000000000000000"
    ]
}